{
  "id": "aldera-outskirts",
  "name": "Aldera Outskirts",
  "width": 20,
  "height": 15,
  "solidTiles": [2, 3, 4, 5, 10],
  "playerStart": { "x": 9, "y": 12 },
  "tiles": [
    [3,3,3,3,3,3,3,3,3,1,3,3,3,3,3,3,3,3,3,3],
    [3,0,0,0,0,0,0,0,0,1,0,0,0,10,0,4,4,4,0,3],
    [3,0,0,5,5,5,5,0,0,1,0,0,0,10,0,4,4,4,0,3],
    [3,0,0,5,5,5,5,0,0,1,0,0,0,10,0,4,0,0,0,3],
    [3,0,0,4,6,4,4,0,0,1,0,0,0,10,0,0,0,0,0,3],
    [3,0,0,0,0,0,0,0,0,1,0,0,0,10,0,0,0,0,0,3],
    [3,0,0,0,0,0,0,0,0,1,0,0,0,10,0,0,0,0,0,3],
    [3,1,1,1,1,1,1,1,1,1,1,1,1,9,0,0,0,0,0,3],
    [3,0,0,0,0,0,0,0,0,1,0,0,0,10,0,0,0,0,0,3],
    [3,0,0,0,0,0,0,0,0,1,0,0,0,10,0,0,0,0,0,3],
    [3,0,0,2,2,2,2,0,0,1,0,0,0,10,10,10,10,10,10,3],
    [3,0,0,2,2,2,2,0,0,1,0,0,0,0,0,0,0,0,0,3],
    [3,0,0,2,2,2,2,0,0,1,0,0,0,0,0,0,0,0,0,3],
    [3,0,0,0,0,0,0,0,0,1,0,0,0,0,0,0,0,0,0,3],
    [3,3,3,3,3,3,3,3,3,3,3,3,3,3,3,3,3,3,3,3]
  ],
  "props": [
    { "sheet": [64, 496, 56, 64], "x": 15, "y": 1 }
  ],
  "npcs": [
    {
      "id": "kid_pell",
      "name": "Pell",
      "x": 7,
      "y": 11,
      "dialogueId": "kid_pond",
      "color": 13789470
    }
  ],
  "triggers": [
    { "x": 9, "y": 0, "target": "aldera-village", "targetX": 11, "targetY": 13 },
    { "x": 16, "y": 3, "target": "aurin-approach", "targetX": 7, "targetY": 8 },
    { "x": 17, "y": 3, "target": "aurin-approach", "targetX": 7, "targetY": 8 }
  ]
}
