{
  "id": "aurin-shrine",
  "name": "Aurin Shrine",
  "width": 14,
  "height": 22,
  "solidTiles": [4, 7, 8, 10],
  "playerStart": { "x": 7, "y": 20 },
  "tiles": [
    [4,4,4,4,4,4,4,4,4,4,4,4,4,4],
    [4,1,1,1,1,1,1,1,1,1,1,1,1,4],
    [4,1,1,1,1,1,7,7,1,1,1,1,1,4],
    [4,1,1,1,1,1,1,1,1,1,1,1,1,4],
    [4,1,1,1,1,1,1,1,1,1,1,1,1,4],
    [4,1,1,1,1,1,1,1,1,1,1,1,1,4],
    [4,1,1,1,1,1,1,1,1,1,1,1,1,4],
    [4,1,1,1,1,1,1,1,1,1,1,1,1,4],
    [4,1,1,1,1,1,1,1,1,1,1,1,1,4],
    [4,1,1,1,1,1,1,1,1,1,1,1,1,4],
    [4,4,4,4,4,4,4,8,4,4,4,4,4,4],
    [4,1,1,1,1,1,1,1,1,1,1,1,1,4],
    [4,1,1,1,1,1,1,1,1,1,1,1,1,4],
    [4,1,1,11,1,1,1,1,1,1,1,1,1,4],
    [4,1,1,1,1,1,1,1,1,1,1,1,1,4],
    [4,1,1,1,1,1,1,1,1,1,1,1,1,4],
    [4,1,1,1,1,1,1,1,1,1,1,1,1,4],
    [4,1,1,1,1,1,1,1,1,1,1,1,1,4],
    [4,1,1,1,1,1,1,1,1,1,1,1,1,4],
    [4,1,1,1,1,1,1,1,1,1,1,1,1,4],
    [4,1,1,1,1,1,1,1,1,1,1,1,1,4],
    [4,4,4,4,4,4,4,1,4,4,4,4,4,4]
  ],
  "blocks": [{ "x": 5, "y": 13 }],
  "puzzle": {
    "plates": [{ "x": 3, "y": 13 }],
    "gates": [{ "x": 7, "y": 10 }],
    "solvedFlag": "shrine_gate_open"
  },
  "npcs": [
    {
      "id": "warden",
      "name": "The Warden",
      "x": 6,
      "y": 4,
      "dialogueId": "warden_first",
      "color": 10132136
    }
  ],
  "triggers": [
    { "x": 7, "y": 21, "target": "aldera-outskirts", "targetX": 16, "targetY": 5 }
  ],
  "onEnter": [
    { "unless": ["shrine_seen"], "dialogueId": "seal_broken", "set": ["shrine_seen", "shrine_breached"] }
  ]
}
