{
  "id": "vale-outskirts",
  "name": "Aldera Outskirts",
  "width": 20,
  "height": 15,
  "solidTiles": [2, 3, 4, 5, 6],
  "playerStart": { "x": 9, "y": 12 },
  "tiles": [
    [3,3,3,3,3,3,3,3,3,3,3,3,3,3,3,3,3,3,3,3],
    [3,0,0,0,0,0,0,0,0,1,0,0,0,0,0,0,0,0,0,3],
    [3,0,0,5,5,5,5,0,0,1,0,0,0,0,0,0,0,0,0,3],
    [3,0,0,5,5,5,5,0,0,1,0,0,0,0,0,0,0,0,0,3],
    [3,0,0,4,6,4,4,0,0,1,0,0,0,0,0,0,0,0,0,3],
    [3,0,0,0,0,0,0,0,0,1,0,0,0,0,0,0,0,0,0,3],
    [3,0,0,0,0,0,0,0,0,1,0,0,0,0,0,0,0,0,0,3],
    [3,1,1,1,1,1,1,1,1,1,1,1,1,1,1,1,1,1,1,3],
    [3,0,0,0,0,0,0,0,0,1,0,0,0,0,0,0,0,0,0,3],
    [3,0,0,0,0,0,0,0,0,1,0,0,0,2,2,2,2,2,0,3],
    [3,0,0,0,0,0,0,0,0,1,0,0,0,2,2,2,2,2,0,3],
    [3,0,0,0,0,0,0,0,0,1,0,0,0,2,2,2,2,2,0,3],
    [3,0,0,0,0,0,0,0,0,1,0,0,0,0,0,0,0,0,0,3],
    [3,0,0,0,0,0,0,0,0,1,0,0,0,0,0,0,0,0,0,3],
    [3,3,3,3,3,3,3,3,3,3,3,3,3,3,3,3,3,3,3,3]
  ],
  "npcs": [
    {
      "id": "elder_thane",
      "name": "Elder Thane",
      "x": 8,
      "y": 8,
      "dialogueId": "elder_intro",
      "color": 9127187
    },
    {
      "id": "kid_pell",
      "name": "Pell",
      "x": 14,
      "y": 5,
      "dialogueId": "kid_pond",
      "color": 13789470
    }
  ]
}
